*** Maze ***

▓▓▓▓▓▓▓▓▓▓▓▓▓▓▓▓▓▓▓▓▓▓▓▓▓▓▓▓▓▓▓▓▓▓▓▓▓▓▓▓▓▓▓▓▓▓▓▓▓▓▓
▓░▓░░░░░░░░░░░░░░░▓░░░░░▓░░░░░░░░░░░▓░░░░░░░░░▓░░░▓
▓░▓░▓▓▓░▓░▓▓▓▓▓▓▓░▓░▓▓▓░▓░▓▓▓▓▓░▓▓▓░▓░▓▓▓▓▓▓▓░▓░▓░▓
▓░░░▓░▓░▓░▓░░░░░▓░▓░▓░▓░▓░░░░░▓░░░▓░░░▓░░░▓░░░▓░▓░▓
▓░▓▓▓░▓░▓▓▓░▓▓▓░▓▓▓░▓░▓░▓▓▓▓▓░▓▓▓░▓▓▓▓▓░▓░▓░▓▓▓░▓░▓
▓░▓░░░▓░░░░░░░▓░▓░░░░░▓░░░░░▓░░░▓░░░░░▓░▓░▓░▓░▓░▓░▓
▓░▓░▓░▓▓▓▓▓▓▓▓▓░▓░▓▓▓▓▓▓▓░▓░▓▓▓░▓▓▓▓▓░▓░▓▓▓░▓░▓░▓░▓
▓░░░▓░░░▓░░░▓░░░▓░▓░░░░░▓░▓░▓░░░░░▓░░░▓░░░░░▓░░░▓░▓
▓▓▓▓▓▓▓░▓▓▓░▓░▓░▓░▓░▓▓▓░▓▓▓░▓░▓▓▓▓▓░▓▓▓░▓▓▓▓▓▓▓▓▓░▓
▓░▓░░░▓░░░░░▓░▓░▓░▓░▓░▓░░░░░▓░░░▓░░░▓░▓░▓░░░░░░░░░▓
▓░▓░▓░▓░▓▓▓▓▓░▓▓▓░▓░▓░▓▓▓▓▓░▓░▓▓▓░▓▓▓░▓░▓▓▓▓▓░▓▓▓▓▓
▓░░░▓░░░▓░░░▓░░░▓░▓░▓░▓░░░░░▓░▓░░░▓░░░▓░░░░░▓░░░░░▓
▓░▓▓▓▓▓▓▓░▓░▓▓▓░▓░▓░▓░▓░▓▓▓▓▓░▓░▓▓▓░▓▓▓▓▓▓▓░▓▓▓▓▓░▓
▓░▓░░░▓░▓░▓░░░░░▓░▓░▓░░░░░▓░░░▓░░░▓░▓░░░░░▓░░░░░▓░▓
▓░▓░▓░▓░▓░▓▓▓▓▓▓▓░▓░▓░▓▓▓▓▓░▓▓▓▓▓░▓░▓░▓░▓▓▓▓▓▓▓░▓░▓
▓░░░▓░░░▓░▓░░░░░░░▓░▓░▓░░░░░▓░░░▓░▓░░░▓░░░░░░░▓░▓░▓
▓▓▓▓▓▓▓░▓░▓░▓▓▓▓▓▓▓░▓░▓░▓▓▓▓▓░▓▓▓░▓▓▓░▓▓▓▓▓░▓░▓░▓░▓
▓░░░░░▓░▓░░░▓░░░░░░░▓░▓░▓░░░░░░░▓░░░▓░░░░░▓░▓░▓░▓░▓
▓░▓░▓▓▓░▓▓▓▓▓░▓▓▓░▓▓▓▓▓░▓▓▓▓▓▓▓░▓▓▓░▓▓▓░▓▓▓░▓░▓░▓░▓
▓░▓░░░░░░░░░▓░▓░░░▓░░░░░░░░░▓░░░░░▓░▓░░░▓░░░▓░▓░░░▓
▓░▓▓▓▓▓▓▓▓▓▓▓░▓░▓▓▓░▓▓▓▓▓▓▓░▓░▓▓▓░▓░▓░▓▓▓░▓▓▓▓▓▓▓░▓
▓░░░░░▓░░░░░░░▓░░░▓░░░▓░░░▓░░░▓░░░▓░▓░░░▓░▓░░░░░▓░▓
▓▓▓▓▓░▓░▓▓▓▓▓▓▓▓▓▓▓░▓▓▓░▓░▓▓▓▓▓▓▓▓▓░▓▓▓░▓░▓░▓▓▓░▓░▓
▓░░░░░▓░░░░░░░░░░░░░▓░░░▓░░░░░░░░░░░▓░░░▓░░░░░▓░░░▓
▓▓▓▓▓▓▓▓▓▓▓▓▓▓▓▓▓▓▓▓▓▓▓▓▓▓▓▓▓▓▓▓▓▓▓▓▓▓▓▓▓▓▓▓▓▓▓▓▓▓▓