*** Maze ***

▓▓▓▓▓▓▓▓▓▓▓▓▓▓▓▓▓▓▓▓▓▓▓▓▓▓▓▓▓▓▓▓▓▓▓▓▓▓▓▓▓▓▓▓▓▓▓▓▓▓▓
▓░░░░░░░░░░░░░░░░░░░░░▓░░░░░░░░░░░░░░░░░░░░░░░░░░░▓
▓░▓░▓▓▓▓▓░▓▓▓▓▓▓▓▓▓▓▓▓▓░▓░▓▓▓▓▓▓▓▓▓▓▓▓▓░▓▓▓▓▓▓▓▓▓░▓
▓░▓░▓░░░▓░▓░░░░░░░░░░░░░▓░░░░░▓░░░▓░░░░░▓░░░░░░░▓░▓
▓░▓░▓░▓░▓░▓░▓▓▓▓▓▓▓▓▓▓▓▓▓▓▓▓▓░▓░▓░▓░▓▓▓▓▓░▓▓▓▓▓░▓▓▓
▓░▓░▓░▓░░░▓░▓░░░░░░░▓░░░░░░░▓░░░▓░▓░▓░░░▓░░░░░▓░░░▓
▓▓▓░▓░▓▓▓▓▓░▓░▓░▓▓▓░▓░▓▓▓░▓░▓▓▓▓▓░▓▓▓░▓░▓▓▓▓▓░▓▓▓░▓
▓░░░▓░▓░░░░░▓░▓░▓░▓░▓░░░▓░▓░▓░░░▓░▓░░░▓░▓░░░▓░░░▓░▓
▓░▓▓▓▓▓░▓▓▓▓▓░▓░▓░▓░▓▓▓░▓░▓░▓▓▓░▓░▓░▓▓▓░▓░▓░▓▓▓░▓░▓
▓░▓░░░▓░░░▓░░░▓░▓░░░▓░░░▓░▓░░░░░▓░░░░░▓░░░▓░▓░░░▓░▓
▓░▓░▓░▓▓▓░▓▓▓▓▓░▓░▓▓▓▓▓▓▓░▓░▓▓▓░▓▓▓▓▓▓▓▓▓▓▓░▓░▓▓▓░▓
▓░▓░▓░░░▓░░░░░░░▓░░░▓░░░░░▓░▓░▓░░░▓░░░░░░░▓░░░▓░░░▓
▓░▓░▓░▓▓▓▓▓▓▓▓▓▓▓▓▓░▓░▓▓▓▓▓▓▓░▓▓▓░▓░▓▓▓▓▓░▓░▓▓▓░▓▓▓
▓░░░▓░░░░░▓░░░░░░░▓░▓░░░░░▓░░░▓░░░▓░░░▓░▓░▓░░░▓░░░▓
▓░▓▓▓▓▓░▓░▓▓▓░▓▓▓░▓░▓▓▓▓▓░▓░▓▓▓▓▓░▓▓▓░▓░▓░▓▓▓░▓▓▓░▓
▓░░░░░▓░▓░░░▓░▓░▓░▓░░░░░▓░▓░░░░░▓░▓░░░▓░░░▓░░░▓░░░▓
▓▓▓░▓▓▓░▓▓▓░▓░▓░▓░▓▓▓▓▓░▓░▓▓▓▓▓░▓░▓░▓▓▓░▓▓▓▓▓▓▓░▓░▓
▓░░░▓░░░▓░▓░▓░░░▓░░░░░▓░░░░░▓░▓░▓░▓░▓░░░▓░░░░░░░▓░▓
▓░▓▓▓░▓▓▓░▓░▓▓▓▓▓░▓▓▓▓▓▓▓▓▓░▓░▓░▓░▓░▓░▓▓▓▓▓░▓▓▓▓▓░▓
▓░▓░░░▓░░░░░░░░░░░▓░░░░░░░▓░▓░▓░▓░▓░▓░▓░░░░░▓░░░▓░▓
▓░▓░▓▓▓▓▓▓▓░▓▓▓▓▓░▓░▓▓▓▓▓░▓░▓░▓░▓▓▓░▓░▓▓▓░▓▓▓░▓▓▓░▓
▓░▓░░░▓░░░▓░▓░░░▓░▓░░░▓░▓░░░▓░▓░▓░░░▓░░░░░▓░░░▓░░░▓
▓░▓▓▓░▓░▓░▓▓▓░▓░▓▓▓▓▓░▓░▓▓▓▓▓░▓░▓░▓▓▓▓▓▓▓▓▓░▓░▓░▓▓▓
▓░░░▓░░░▓░░░░░▓░░░░░░░░░░░░░░░▓░░░▓░░░░░░░░░▓░░░░░▓
▓▓▓▓▓▓▓▓▓▓▓▓▓▓▓▓▓▓▓▓▓▓▓▓▓▓▓▓▓▓▓▓▓▓▓▓▓▓▓▓▓▓▓▓▓▓▓▓▓▓▓