*** Maze ***

▓▓▓▓▓▓▓▓▓▓▓▓▓▓▓▓▓▓▓▓▓▓▓▓▓▓▓▓▓▓▓▓▓▓▓▓▓▓▓▓▓▓▓▓▓▓▓▓▓▓▓
▓░░░░░▓░░░░░▓░░░░░▓░░░░░░░▓░░░░░░░░░░░░░░░░░░░░░░░▓
▓░▓░▓░▓▓▓▓▓░▓░▓▓▓░▓░▓▓▓▓▓░▓▓▓▓▓░▓▓▓▓▓▓▓░▓░▓░▓▓▓▓▓░▓
▓░▓░▓░░░░░▓░▓░░░▓░▓░▓░▓░░░▓░░░▓░▓░░░░░▓░▓░▓░▓░░░▓░▓
▓░▓░▓▓▓▓▓░▓░▓▓▓░▓░▓░▓░▓░▓▓▓░▓░▓▓▓░▓▓▓░▓▓▓░▓▓▓░▓░▓░▓
▓░▓░▓░░░░░░░░░▓░▓░▓░▓░▓░▓░░░▓░░░░░▓░▓░░░▓░░░░░▓░▓░▓
▓▓▓░▓▓▓▓▓▓▓░▓▓▓░▓░▓░▓░▓░▓░▓▓▓▓▓▓▓▓▓░▓▓▓░▓▓▓▓▓▓▓░▓▓▓
▓░░░▓░░░▓░░░▓░░░▓░▓░▓░▓░░░▓░░░▓░░░░░░░▓░░░░░░░▓░░░▓
▓░▓▓▓░▓░▓▓▓▓▓░▓▓▓░▓░▓░▓▓▓▓▓░▓░▓░▓▓▓░▓▓▓▓▓▓▓▓▓░▓▓▓░▓
▓░▓░░░▓░░░░░▓░▓░▓░░░▓░░░▓░░░▓░░░▓░▓░░░░░░░░░▓░▓░░░▓
▓░▓░▓▓▓▓▓▓▓░▓░▓░▓▓▓▓▓░▓░▓▓▓░▓▓▓▓▓░▓▓▓░▓▓▓▓▓░▓▓▓░▓▓▓
▓░▓░░░▓░░░▓░░░▓░░░▓░░░▓░░░▓░░░░░░░░░▓░░░░░▓░▓░░░░░▓
▓░▓▓▓░▓▓▓░▓▓▓▓▓░▓░▓░▓▓▓▓▓░▓▓▓░▓▓▓▓▓▓▓░▓▓▓░▓▓▓░▓▓▓░▓
▓░░░▓░░░▓░░░░░░░▓░░░▓░░░▓░░░▓░▓░░░░░▓░░░▓░░░░░░░▓░▓
▓░▓▓▓▓▓░▓▓▓▓▓▓▓░▓▓▓▓▓░▓░▓▓▓░▓░▓░▓▓▓░▓▓▓░▓▓▓▓▓▓▓▓▓░▓
▓░░░░░▓░░░▓░░░▓░░░▓░░░▓░▓░░░▓░▓░▓░▓░▓░░░░░░░▓░▓░░░▓
▓░▓▓▓░▓▓▓░▓░▓░▓▓▓░▓░▓░▓░▓░▓▓▓░▓░▓░▓░▓▓▓▓▓▓▓░▓░▓░▓▓▓
▓░░░▓░░░░░▓░▓░░░░░▓░▓░▓░▓░▓░░░▓░▓░▓░░░▓░░░▓░░░▓░░░▓
▓▓▓░▓▓▓▓▓▓▓░▓▓▓▓▓▓▓░▓░▓▓▓░▓▓▓▓▓░▓░▓▓▓░▓░▓░▓▓▓▓▓▓▓░▓
▓░░░▓░░░░░▓░▓░░░░░▓░▓░░░▓░░░▓░░░▓░░░░░▓░▓░░░░░▓░░░▓
▓░▓▓▓░▓▓▓░▓░▓░▓▓▓░▓░▓▓▓░▓▓▓░▓░▓▓▓░▓▓▓▓▓░▓▓▓▓▓░▓░▓░▓
▓░▓░░░░░▓░▓░▓░░░▓░▓░▓░▓░░░░░▓░▓░░░▓░░░░░▓░░░▓░░░▓░▓
▓░▓▓▓▓▓░▓░▓░▓░▓░▓▓▓░▓░▓▓▓▓▓▓▓░▓░▓▓▓░▓▓▓▓▓░▓▓▓▓▓▓▓░▓
▓░░░░░░░▓░░░▓░▓░░░░░░░░░░░░░░░▓░░░░░▓░░░░░░░░░░░░░▓
▓▓▓▓▓▓▓▓▓▓▓▓▓▓▓▓▓▓▓▓▓▓▓▓▓▓▓▓▓▓▓▓▓▓▓▓▓▓▓▓▓▓▓▓▓▓▓▓▓▓▓